Goi-sorabiera-Euskara=hsb
Letoniera-Euskara=lv
Arabiera-Euskara=ar
Hawaiera-Euskara=haw
Laburtzapenak_ingelesez=en
Onomatopeiak_ingelesez=en
Ingelesa-Euskara=en
Sigloideak_ingelesez=en
Ingeleseko_deklinabide_taulak=en
Hizkuntza_erregistroa_ingelesez=en
Akronimoak_ingelesez=en
Kirgizera-Euskara=ky
Marshallera-Euskara=mh
Kaxubiera-Euskara=csb
Haitiko_kreolera-Euskara=ht
Tswanera-Euskara=tn
Zuluera-Euskara=zu
Alemana-Euskara=de
Txantiloiak_alemanez=de
Ido-Euskara=io
Txeroki-Euskara=chr
Thailandiera-Euskara=th
Eskoziako_gaelera-Euskara=gd
Galiziera-Euskara=gl
Txetxeniera-Euskara=ce
Friulera-Euskara=fur
Aimara-Euskara=ay
Kazakhera-Euskara=kk
Livoniera-Euskara=liv
Etimologia_greziera_zaharrez=grc
Greziera_zaharra-Euskara=grc
Aditzak_grekera_zaharrez=grc
Latin-Euskara=la
Akronimoak_latinez=la
Latinezko_txantiloiak=la
Kaxmirera-Euskara=ks
Poloniera-Euskara=pl
Polonierazko_txantiloiak=pl
Georgiera-Euskara=ka
Okzitaniera-Euskara=oc
Cheyennera-Euskara=chy
Tajikera-Euskara=tg
Txantiloiak_eslovenieraz=sl
Esloveniera-Euskara=sl
Asturiera-Euskara=ast
Faroeera-Euskara=fo
Adigera-Euskara=ady
Galesera-Euskara=cy
Txantiloiak_turkieraz=tr
Turkiera-Euskara=tr
Kornubiera-Euskara=kw
Napoliera-Euskara=nap
Frisiera-Euskara=fy
Volap√ºk-Euskara=vo
Txantiloiak_esperantoz=eo
Laburtzapenak_esperantoz=eo
Esperanto-Euskara=eo
Esperantoaren_gramatika=eo
Lituaniera-Euskara=lt
Armeniera-Euskara=hy
Kareliera-Euskara=krl
Tamilera-Euskara=ta
Gaztelania-Euskara=es
Onomatopeiak_gaztelaniaz=es
Hizkuntza_erregistroa_gaztelaniaz=es
Atsotitzak_gaztelaniaz=es
Katalana-Euskara=ca
Txantiloiak_katalanez=ca
Indonesiera-Euskara=id
Luxenburgera-Euskara=lb
Lokailuak_euskaraz=eu
Laburketak_euskaraz=eu
Laburtzapenak_euskaraz=eu
Hizkuntza_erregistroa_euskaraz=eu
Adberbioak_euskaraz=eu
Juntagailuak_euskaraz=eu
Aditzak_euskaraz=eu
Etimologia_euskaraz=eu
Akronimoak_euskaraz=eu
Palindromoak_euskaraz=eu
Laburdurak_euskaraz=eu
Onomatopeiak_euskaraz=eu
Interjekzioak_euskaraz=eu
Adjektiboak_euskaraz=eu
Izenordainak_euskaraz=eu
Hitz_bikoitzak_euskaraz=eu
Apokopeak_euskaraz=eu
Zenbatzaileak_euskaraz=eu
Lokuzioak_euskaraz=eu
Atsotitzak_euskaraz=eu
Atzizkiak_euskaraz=eu
Izenak_euskaraz=eu
Guaraniera-Euskara=gun
Korsikera-Euskara=co
Urdu-Euskara=ur
Bengalera-Euskara=bn
Nauruera-Euskara=na
Kurduera-Euskara=ku
Txantiloiak_bielorrusieraz=be
Bielorrusiera-Euskara=be
Swaziera-Euskara=ss
Suediera-Euskara=sv
Manxera-Euskara=gv
Finlandiera-Euskara=fi
Ukrainera-Euskara=uk
Txantiloiak_ukraineraz=uk
Extremadurera-Euskara=ext
Txantiloiak_errusieraz=ru
Errusiera-Euskara=ru
Navajo-Euskara=nv
Maltera-Euskara=mt
Siziliera-Euskara=scn
Turkmenera-Euskara=tk
Bretoiera-Euskara=br
Sardiniera-Euskara=sc
Islandiera-Euskara=is
Txuvaxiera-Euskara=cv
Hindi-Euskara=hi
Italiera-Euskara=it
Wolofera-Euskara=wo
Samoera-Euskara=sm
Malaiera-Euskara=ms
Maoriera-Euskara=mi
Somaliera-Euskara=so
Albaniera-Euskara=sq
Txinera-Euskara=zh
Norvegiera-Euskara=no
Errumaniera-Euskara=ro
Azerbaijanera-Euskara=az
Swahili-Euskara=sw
Txantiloiak_txekieraz=cs
Txekierazko_txantiloiak=cs
Txekiera-Euskara=cs
Hebreera-Euskara=iw
Tatarera-Euskara=tt
Baxkirera-Euskara=ba
Txantiloiak_eslovakieraz=sk
Eslovakiera-Euskara=sk
Nederlandera-Euskara=nl
Daniera-Euskara=da
Paxtuera-Euskara=ps
Malgaxe-Euskara=mg
Mongoliera-Euskara=mn
Kitxua-Euskara=qu
Estoniera-Euskara=et
Yiddish-Euskara=yi
Groenlandiera-Euskara=kl
Fijiera-Euskara=fj
Uzbekera-Euskara=uz
Afrikaans-Euskara=af
Bulgariera-Euskara=bg
Veneziera-Euskara=vec
Persiera-Euskara=prp
Portugalera-Euskara=pt
Behe-sorabiera-Euskara=dsb
Interlingua-Euskara=ia
Vietnamera-Euskara=vi
Txantiloiak_mazedonieraz=mk
Mazedoniera-Euskara=mk
Cebuera-Euskara=ceb
Aragoiera-Euskara=an
Koreera-Euskara=ko
Erromantxera-Euskara=rm
Tibetera-Euskara=bo
Hungariera-Euskara=hu
Txantiloiak_hungarieraz=hu
Khmerera-Euskara=km
Japoniera-Euskara=ja
Txantiloiak_grezieraz=el
Greziera-Euskara=el
Hizkuntza_erregistroa_frantsesez=fr
Onomatopeiak_frantsesez=fr
Txantiloiak_frantsesez=fr
Frantsesa-Euskara=fr
Gaiak_frantsesez=fr
Abkhazera-Euskara=ab
