Górnosorbsczi=hsb
Lëtewsczi=lv
Arabsczi=ar
Anielsczi=en
Kaszëbsczi=csb
Miemiecczi=de
Ido=io
Tajsczi=th
Galicëjsczi=gl
Frijulsczi=fur
łacëzna\ (indeks)=la
Pòlsczi=pl
Grëzóńsczi=ka
Sloweńsczi=sl
Asturëjsczi=ast
szkòcczi\ (indeks)=sco
Walijsczi=cy
tërecczi\ (indeks)=tr
Kòrnwalijsczi=kw
Volapük=vo
Esperanto=eo
Stôrocerkwiowòsłowiańsczi=cu
Tamil=ta
Szpańsczi=es
Telugu=te
Katalońsczi=ca
Indonezëjsczi=id
Luksembùrsczi=lb
Baskijsczi=eu
Kòrsykańsczi=co
Tok\ Pisin=tpi
Kùrdyjsczi=ku
Biôłorusczi=be
Szwedzczi=sv
Fińsczi=fi
Ùkrajińsczi=uk
Rusczi=ru
Maltańsczi=mt
Sycylijsczi=scn
Bretońsczi=br
Islandzczi=is
Hindi=hi
Italsczi=it
Malajsczi=ms
Albańsczi=sq
Chińsczi=zh
Norwesczi=no
Rumùńsczi=ro
Suahili=sw
Czesczi=cs
Hebrajsczi=iw
Tatarsczi=tt
Słowacczi=sk
Hòlandzczi=nl
Dëńsczi=da
Estońsczi=et
Jidisz=yi
Tagalog=tl
Afrikanersczi=af
Bùlgarsczi=bg
Persczi=prp
Pòrtugalsczi=pt
Dolnosorbsczi=dsb
Interlingua=ia
Macedońsczi=mk
Aragòńsczi=an
Stôroanielsczi=ang
Kòrejańsczi=ko
Madżarsczi=hu
Japòńsczi=ja
Grecczi=el
Francësczi=fr
deks)=sw
czesczi_(indeks)=cs
hebrajsczi_(indeks)=iw
tatarsczi_(indeks)=tt
słowacczi_(indeks)=sk
hòlandzczi_(indeks)=nl
dëńsczi_(indeks)=da
estońsczi_(indeks)=et
jidisz_(indeks)=yi
tagalog_(indeks)=tl
afrikanersczi_(indeks)=af
Afrikaans=af
bùlgarsczi_(indeks)=bg
persczi_(indeks)=prp
pòrtugalsczi_(indeks)=pt
dolnosorbsczi_(indeks)=dsb
interlingua_(indeks)=ia
Interlingua_(indeks)=ia
macedońsczi_(indeks)=mk
aragòńsczi_(indeks)=an
stôroanielsczi_(indeks)=ang
kòrejańsczi_(indeks)=ko
madżarsczi_(indeks)=hu
japòńsczi_(indeks)=ja
grecczi_(indeks)=el
francësczi_(indeks)=fr
