hornjoserbšćina=hsb
letišćina=lv
arabšćina=ar
jendźelšćina=en
kašubšćina=csb
němčina=de
pólšćina=pl
słowjenšćina=sl
esperanto=eo
litawšćina=lt
karelšćina=krl
katalanšćina=ca
běłorušćina=be
šwedšćina=sv
finšćina=fi
hindišćina=hi
albanšćina=sq
chinšćina=zh
norwegšćina=no
rumunšćina=ro
hebrejšćina=iw
nižozemšćina=nl
danšćina=da
mongolšćina=mn
estišćina=et
bołharšćina=bg
persišćina=prp
portugalšćina=pt
delnjoserbšćina=dsb
makedonšćina=mk
korejšćina=ko
madźaršćina=hu
grjekšćina=el
francošćina=fr
stantiw_(rumunšćina)=ro
substantiw_(danšćina)=da
substantiw_(delnjoserbšćina)=dsb
