અરબી=ar
આમ્હારિક=am
અંગ્રેજી=en
ઝૂલૂ=zu
જર્મન=de
થાઇ=th
લૅટિન=la
કશ્મીરી=ks
પોલિશ=pl
જ્યોર્જિયન=ka
એસ્પેરાન્તો=eo
પાલી=pi
આર્મેનિયન=hy
તમિલ=ta
તેલુગુ=te
ઉર્દૂ=ur
બંગાળી=bn
બેલારુસી=be
સિન્ધી=sd
સ્વીડિશ=sv
સંસ્કૃત=sa
ફિન્નિશ=fi
યુક્રેનિયન=uk
રૂસી=ru
ભોજપુરી=bho
કન્નડ=kn
હિન્દી=hi
ઇટાલિયન=it
આલ્બાનિયન=sq
ચીની=zh
રોમેનિયન=ro
ચેક=cs
હીબ્રૂ=iw
ડચ=nl
મંગોલિયન=mn
મરાઠી=mr
મલયાલમ=ml
અફ્રીકી=af
બલ્ગેરિયન=bg
આસામી=as
પંજાબી=pa
ગુજરાતી=gu
ફારસી=prp
કોરિયન=ko
ટિબેટન=bo
જાપાની=ja
ગ્રીક=el
ફ્રાન્સીસી=fr
