#lng2name_NO
Latvisk=lv
Arabisk=ar
Amharisk=am
Engelsk=en
Kasjubisk=csb
Haitisk\ kreolsk=ht
Tysk=de
Ido=io
Cherokee=chr
Thai=th
Skotsk-gælisk=gd
Galisisk=gl
Serbokroatisk=sh
Gammelgresk=grc
Latin=la
Kasjmiri=ks
Polsk=pl
Georgisk=ka
Nordsamisk=se
Slovensk=sl
Asturiansk=ast
Skotsk=sco
Færøysk=fo
Tyrkisk=tr
Volapyk=vo
Esperanto=eo
Litauisk=lt
Armensk=hy
Gammelkirkeslavisk=cu
Spansk=es
Telugu=te
Katalansk=ca
Indonesisk=id
Luxembourgisk=lb
Baskisk=eu
Guaraní=gun
Urdu=ur
Bengali=bn
Naurisk=na
Sundanesisk=su
Kurdisk=ku
Hviterussisk=be
Swati=ss
Svensk=sv
Bambara=bm
Finsk=fi
Ukrainsk=uk
Russisk=ru
Maltesisk=mt
Arameisk=arc
Bretonsk=br
Norrønt=non
Islandsk=is
Hindi=hi
Ainu=aib
Nahuati=nah
Italiensk=it
Limburgisk=li
Malayisk=ms
Maori=mi
Albanske\ språk=sq
Kinesisk=zh
Norsk=no
Rumensk=ro
Aserbajdsjansk=az
Tsjekkisk=cs
Hebraisk=iw
Slovakisk=sk
Nederlandsk=nl
Dansk=da
Gassisk=mg
Sesotho=st
Novial=nov
Malayalam=ml
Estisk=et
Jiddisch=yi
Fijiansk=fj
Tagalog=tl
Afrikaans=af
Bulgarsk=bg
Persisk=prp
Portugisisk=pt
Lavsorbisk=dsb
Interlingua=ia
Vietnamesisk=vi
Jødespansk=lad
Makedonsk=mk
Gotisk=got
Aragonesisk=an
Koreansk=ko
Ungarsk=hu
Japansk=ja
Gresk=el
Fransk=fr
#Tue Apr 10 01:09:46 CEST 2012
norsk\ (Norge)=no
norsk\ (Norge,nynorsk)=no
