#lng2name_EU
Goi-sorabiera=hsb
Letoniera=lv
Arabiera=ar
Hawaiera=haw
Ingelesa=en
Kirgizera=ky
Marshallera=mh
Kaxubiera=csb
Haitiko\ kreolera=ht
Tswanera=tn
Zuluera=zu
Alemana=de
Ido=io
Txeroki=chr
Thailandiera=th
Eskoziako\ gaelera=gd
Galiziera=gl
Txetxeniera=ce
Friulera=fur
Aimara=ay
Kazakhera=kk
Livoniera=liv
Greziera\ zaharra=grc
Latin=la
Kaxmirera=ks
Poloniera=pl
Georgiera=ka
Okzitaniera=oc
Cheyennera=chy
Tajikera=tg
Esloveniera=sl
Asturiera=ast
Faroeera=fo
Adigera=ady
Galesera=cy
Turkiera=tr
Kornubiera=kw
Napoliera=nap
Frisiera=fy
Volap√ºk=vo
Esperanto=eo
Lituaniera=lt
Armeniera=hy
Kareliera=krl
Tamilera=ta
Gaztelania=es
Katalana=ca
Indonesiera=id
Luxenburgera=lb
Euskara=eu
Guaraniera=gun
Korsikera=co
Urdu=ur
Bengalera=bn
Nauruera=na
Kurduera=ku
Bielorrusiera=be
Swaziera=ss
Suediera=sv
Manxera=gv
Finlandiera=fi
Ukrainera=uk
Extremadurera=ext
Errusiera=ru
Navajo=nv
Maltera=mt
Siziliera=scn
Turkmenera=tk
Bretoiera=br
Sardiniera=sc
Islandiera=is
Txuvaxiera=cv
Hindi=hi
Italiera=it
Wolofera=wo
Samoera=sm
Malaiera=ms
Maoriera=mi
Somaliera=so
Albaniera=sq
Txinera=zh
Norvegiera=no
Errumaniera=ro
Azerbaijanera=az
Swahili=sw
Txekiera=cs
Hebreera=iw
Tatarera=tt
Baxkirera=ba
Eslovakiera=sk
Nederlandera=nl
Daniera=da
Paxtuera=ps
Malgaxe=mg
Mongoliera=mn
Kitxua=qu
Estoniera=et
Yiddish=yi
Groenlandiera=kl
Fijiera=fj
Uzbekera=uz
Afrikaans=af
Bulgariera=bg
Veneziera=vec
Persiera=prp
Portugalera=pt
Behe-sorabiera=dsb
Interlingua=ia
Vietnamera=vi
Mazedoniera=mk
Cebuera=ceb
Aragoiera=an
Koreera=ko
Erromantxera=rm
Tibetera=bo
Hungariera=hu
Khmerera=km
Japoniera=ja
Greziera=el
Frantsesa=fr
Abkhazera=ab
#Tue Apr 10 01:09:46 CEST 2012
