#lng2name_RO
Sorabă\ de\ sus=hsb
Letonă=lv
Arabă=ar
Amhară=am
Hawaiiană=haw
Engleză=en
Kirghiză=ky
Marșaleză=mh
Caşubiană=csb
Pitjantjatjara=pjt
Interlingue=ie
Yoruba=yo
Creolă\ haitiană=ht
Bavareză=bar
Balineză=ban
Tswana=tn
Apalai=apy
Zulu=zu
Germană=de
Bemba=bem
Ido=io
Cherokee=chr
Thailandeză=th
Galeză\ scoțiană=gd
Galiciană=gl
Cecenă=ce
Friulană=fur
Aymara=ay
Divehi=dv
Sârbo-croată=sh
Germană\ de\ jos=nds
Cazacă=kk
Prusacă=prg
Livoniană=liv
Lojban=jbo
Greacă\ antică=grc
Latină=la
Tupinamba=tpn
Sumeriană=sux
Cașmiră=ks
Poloneză=pl
Georgiană=ka
Occitană=oc
Sami\ nordică=se
Tadjică=tg
Slovenă=sl
Scoțiană=sco
Romani=rmn
Faroeză=fo
Aromână=rup
Shona=sn
Galeză=cy
Turcă=tr
Inuktitut=iu
Cornică=kw
Napolitană=nap
Friziană=fy
Volapük=vo
Esperanto=eo
Uigură=ug
Seri=sei
Manciuriană=mnc
Lituaniană=lt
Armeană=hy
Tamilă=ta
Ewe=ee
Cantoneză=zh-yue
Spaniolă=es
Võro=vro
Telugu=te
Catalană=ca
Indoneziană=id
Luxemburgheză=lb
Birmaneză=my
Bască=eu
Guarani=gun
Corsicană=co
Tok\ pisin=tpi
Urdu=ur
Bengaleză=bn
Nauruan=na
Udmurtă=udm
Yucatecă=msd
Sundaleză=su
Kurdă\ centrală=ku
Bielorusă=be
Sindhi=sd
Swati=ss
Rohingya=rhg
Suedeză=sv
Bambară=bm
Sanscrită=sa
Galeză\ Manx=gv
Finlandeză=fi
Pampangană=pam
Engleză\ medie=enm
Ucraineană=uk
Rusă=ru
Navaho=nv
Alabama=akz
Malteză=mt
Siciliană=scn
Turkmenă=tk
Aramaică=arc
Oromo=om
Bretonă=br
Nordică\ veche=non
Sardă=sc
Kanadeză=kn
Islandeză=is
Ciuvașă=cv
Hindi=hi
Ainu=aib
Tigrinia=ti
Liguriană=lij
Lingala=ln
Afară=aa
Nahuatl=nah
Italiană=it
Wolofă=wo
Samoană=sm
Limburgheză=li
Malaeziană=ms
Maori=mi
Tătară\ crimeeană=crh
Somaleză=so
Albaneză=sq
Chineză=zh
Norvegiană=no
Kiribati=gil
Română=ro
Bislama=bi
Azeră=az
Swahili=sw
Kikuyu=ki
Cehă=cs
Ebraică=iw
Tătară=tt
Chickasaw=cic
Ladină=lld
Rwandi=rw
Bașchiră=ba
Neerlandeză=nl
Venda=ve
Daneză=da
Pașto=ps
Cree=cr
Tuvaluană=tvl
Javaneză=jv
Malgașă=mg
Mongolă=mn
Quechua=qu
Marathi=mr
Sotho\ de\ sud=st
Siriană=syr
Novial=nov
Malayalam=ml
Estoniană=et
Twi=tw
Idiș=yi
Xhosa=xh
Ilocano=ilo
Groenlandeză=kl
Fijiană=fj
Tagalog=tl
Uzbekă=uz
Afrikaans=af
Bulgară=bg
Saxonă\ veche=osx
Oriya=or
Venețiană=vec
Punjabi=pa
Gujarati=gu
Persană=prp
Portugheză=pt
Sorabă\ de\ jos=dsb
Interlingua=ia
Vietnameză=vi
Duala=dua
Bughineză=bug
Filipineză=fil
Iudeo-spaniolă=lad
Mirandeză=mwl
Macedoneană=mk
Gotică=got
Cebuană=ceb
Aragoneză=an
Anglo-saxonă=ang
Coreeană=ko
Retoromană=rm
Kongo=kg
Tibetană=bo
Sinhaleză=si
Maghiară=hu
Mandarină=zh
Japoneză=ja
Greacă=el
Franceză=fr
Abhaziană=ab
#Tue Apr 10 01:09:46 CEST 2012
română\ (România)=ro
română=ro
