#lng2name_SV
Högsorbiska=hsb
Avariska=av
Lettiska=lv
Arabiska=ar
Amhariska=am
Hawaiiska=haw
Engelska=en
Kirgiziska=ky
Anglo-normandiska=xno
Marshalliska=mh
Kasjubiska=csb
Pitjantjatjara=pjt
Interlingue=ie
Yoruba=yo
Bayerska=bar
Tswana=tn
Tyska=de
Ido=io
Cherokesiska=chr
Thai=th
Skotsk\ gäliska=gd
Kabyliska=kab
Galiciska=gl
Tjetjenska=ce
Friuliska=fur
Aymara=ay
Divehi=dv
Igbo=ig
Lågtyska=nds
Kazakiska=kk
Liviska=liv
Lojban=jbo
Klassisk\ grekiska=grc
Latin=la
Kashmiri=ks
Polska=pl
Georgiska=ka
Occitanska=oc
Nordsamiska=se
Cheyenne=chy
Tadzjikiska=tg
Slovenska=sl
Asturiska=ast
Lågskotska=sco
Romani=rmn
Fornfranska=fro
Färöiska=fo
Miskito=miq
Kymriska=cy
Turkiska=tr
Inuktitut=iu
Korniska=kw
Frisiska=fy
Volapük=vo
Esperanto=eo
Uiguriska=ug
Litauiska=lt
Armeniska=hy
Tamil=ta
Ewe=ee
Spanska=es
Telugu=te
Katalanska=ca
Indonesiska=id
Luxemburgiska=lb
Burmesiska=my
Baskiska=eu
Guaraní=gun
Korsikanska=co
Mapudungun=arn
Tok\ pisin=tpi
Urdu=ur
Bengali=bn
Nauriska=na
Kurdiska=ku
Vitryska=be
Sindhi=sd
Nederländska/Västflamländska=vls
Siswati=ss
Svenska=sv
Bambara=bm
Sanskrit=sa
Manx=gv
Finska=fi
Ukrainska=uk
Ryska=ru
Maltesiska=mt
Sicilianska=scn
Turkmeniska=tk
Arameiska=arc
Bretonska=br
Fornnordiska=non
Sardiska=sc
Kannada=kn
Isländska=is
Tjuvasjiska=cv
Hindi=hi
Ainu=aib
Enaresamiska=smn
Liguriska=lij
Nahuatl=nah
Italienska=it
Wolof=wo
Samoanska=sm
Limburgiska=li
Sydsamiska=sma
Malajiska=ms
Maori=mi
Krimtatariska=crh
Somaliska=so
Albanska=sq
Kinesiska=zh
Rumänska=ro
Zazaiska=zza
Azerbajdzjanska=az
Swahili=sw
Tjeckiska=cs
Skoltsamiska=sms
Hebreiska=iw
Tatariska=tt
Basjkiriska=ba
Slovakiska=sk
Nederländska=nl
Danska=da
Pashto=ps
Javanesiska=jv
Mongoliska=mn
Quechua=qu
Marathi=mr
Novial=nov
Malayalam=ml
Estniska=et
Jiddisch=yi
Grönländska=kl
Fiji=fj
Tagalog=tl
Uzbekiska=uz
Abazinska=abq
Afrikaans=af
Bulgariska=bg
Punjabi=pa
Gujarati=gu
Portugisiska=pt
Lågsorbiska=dsb
Interlingua=ia
Vietnamesiska=vi
Tahitiska=ty
Filipino=fil
Ladino=lad
Mirandesiska=mwl
Makedonska=mk
Gotiska=got
Cebuano=ceb
Aragonska=an
Fornengelska=ang
Koreanska=ko
Rätoromanska=rm
Kikongo=kg
Tibetanska=bo
Singalesiska=si
Ungerska=hu
Khmer=km
Japanska=ja
Grekiska=el
Franska=fr
#Tue Apr 10 01:09:46 CEST 2012
norska\ (Norge,Nynorsk)=no
engelska\ (Irland)=en
lettiska\ (Lettland)=lv
katalan=ca
vitryska\ (Vitryssland)=be
makedoniska\ (Makedonien)=mk
koreanska\ (Sydkorea)=ko
spanska\ (Colombia)=es
spanska\ (El\ Salvador)=es
arabiska\ (Oman)=ar
kinesiska\ (Kina)=zh
kroatiska=hr
turkiska\ (Turkiet)=tr
franska\ (Frankrike)=fr
indonesiska\ (Indonesien)=in
franska\ (Luxemburg)=fr
grekiska\ (Grekland)=el
slovakiska\ (Slovakien)=sk
tyska\ (Schweiz)=de
spanska\ (Peru)=es
tyska\ (Luxemburg)=de
arabiska\ (Sudan)=ar
svenska=sv
ryska=ru
spanska\ (Chile)=es
nederländska=nl
serbiska\ (Montenegro)=sr
engelska\ (Amerikas\ Förenta\ Stater)=en
malajiska\ (Malaysia)=ms
litauiska=lt
spanska\ (Nicaragua)=es
spanska\ (Spanien)=es
arabiska\ (Syrien)=ar
albanska\ (Albanien)=sq
tyska\ (Österrike)=de
kinesiska\ (Singapore)=zh
isländska\ (Island)=is
tjeckiska=cs
serbiska\ (Serbien\ och\ Montenegro)=sr
ryska\ (Ryssland)=ru
spanska\ (Paraguay)=es
polska\ (Polen)=pl
arabiska\ (Förenade\ Arabemiraten)=ar
norska\ (Norge)=no
hebreiska\ (Israel)=iw
engelska\ (Sydafrika\ )=en
irländska\ (Irland)=ga
bulgariska\ (Bulgarien)=bg
rumänska\ (Rumänien)=ro
hebreiska=iw
arabiska\ (Qatar)=ar
portugisiska\ (Brasilien)=pt
kinesiska\ (Taiwan)=zh
nederländska\ (Belgien)=nl
franska\ (Schweiz)=fr
arabiska\ (Jordanien)=ar
spanska\ (Panama)=es
vietnamesiska\ (Vietnam)=vi
italienska\ (Italien)=it
engelska\ (Filippinerna)=en
koreanska=ko
arabiska\ (Libyen)=ar
arabiska\ (Libanon)=ar
engelska\ (Kanada)=en
spanska\ (Ecuador)=es
spanska\ (Bolivia)=es
grekiska\ (Cypern)=el
spanska\ (Honduras)=es
svenska\ (Sverige)=sv
isländska=is
ungerska\ (Ungern)=hu
ungerska=hu
bulgariska=bg
slovenska\ (Slovenien)=sl
litauiska\ (Litauen)=lt
kinesiska\ (Hongkong)=zh
thailändska\ (Thailand,TH)=th
spanska\ (Dominikanska\ republiken)=es
makedoniska=mk
italienska=it
vitryska=be
engelska\ (Storbritannien)=en
finska\ (Finland)=fi
arabiska\ (Algeriet)=ar
spanska\ (Guatemala)=es
spanska\ (Mexiko)=es
spanska\ (Venezuela)=es
tyska\ (Tyskland)=de
danska=da
serbiska\ (Bosnien\ och\ Herzegovina)=sr
rumänska=ro
franska\ (Kanada)=fr
maltesiska\ (Malta)=mt
nederländska\ (Nederländerna)=nl
thailändska\ (Thailand)=th
spanska\ (Amerikas\ Förenta\ Stater)=es
engelska\ (Nya\ Zeeland)=en
arabiska\ (Egypten)=ar
spanska\ (Argentina)=es
engelska\ (Singapore)=en
portugisiska\ (Portugal)=pt
kinesiska=zh
hindi\ (Indien)=hi
arabiska\ (Kuwait)=ar
katalan\ (Spanien)=ca
arabiska\ (Irak)=ar
tjeckiska\ (Tjeckiska\ republiken)=cs
engelska\ (Australien)=en
engelska\ (Indien)=en
vietnamesiska=vi
ukrainska\ (Ukraina)=uk
japanska\ (Japan)=ja
japanska\ (Japan,JP)=ja
italienska\ (Schweiz)=it
arabiska\ (Saudiarabien)=ar
arabiska\ (Bahrain)=ar
engelska=en
thailändska=th
lettiska=lv
kroatiska\ (Kroatien)=hr
spanska\ (Uruguay)=es
danska\ (Danmark)=da
spanska\ (Costa\ Rica)=es
estniska\ (Estland)=et
franska\ (Belgien)=fr
arabiska\ (Tunisien)=ar
spanska\ (Puerto\ Rico)=es
engelska\ (Malta)=en
serbiska\ (Serbien)=sr
arabiska\ (Marocko)=ar
arabiska\ (Jemen)=ar
