#lng2name_EO
Suprasoraba=hsb
Araba=ar
Angla=en
Germana=de
IO=io
Galega=gl
Ajmara=ay
Platgermana=nds
Latina=la
Pola=pl
Kartvela=ka
SL=sl
Asturia=ast
Feroa=fo
CY=cy
TR=tr
Frisa=fy
Volapuko=vo
Esperanto=eo
Litova=lt
Armena=hy
Malnovslava=cu
Hispana=es
Kataluna=ca
ID=id
Eŭska=eu
GN=gun
UR=ur
BN=bn
NA=na
Belorusa=be
SV=sv
Finna=fi
Ukraina=uk
Rusa=ru
Bretona=br
Islanda=is
Hindia=hi
Itala=it
Albana=sq
ZH=zh
NO=no
Rumana=ro
Azerbajĝana=az
CS=cs
Hebrea=iw
Slovaka=sk
Nederlanda=nl
DA=da
Keĉua=qu
Estona=et
TL=tl
Afrikansa=af
BG=bg
Guĝarata=gu
PT=pt
IA=ia
Aragona=an
KO=ko
Tibeta=bo
Hungara=hu
Japana=ja
EL=el
Franca=fr
#Tue Apr 10 01:09:46 CEST 2012
