#lng2name_BG
Латвийски=lv
Арабски=ar
Английски=en
Немски=de
Тайландски=th
Латински=la
Полски=pl
Таджикски=tg
Словенски=sl
Фарьорски=fo
Турски=tr
Есперанто=eo
Литовски=lt
Арменски=hy
Испански=es
Индонезийски=id
Люксембургски=lb
Баски=eu
Гуарани=gun
Белоруски=be
Шведски=sv
Фински=fi
Украински=uk
Руски=ru
Малтийски=mt
Исландски=is
Хинди=hi
Италиански=it
Малайски=ms
Китайски=zh
Норвежки=no
Румънски=ro
Чешки=cs
Словашки=sk
Холандски=nl
Датски=da
Естонски=et
Идиш=yi
Африкаанс=af
Български=bg
Персийски=prp
Португалски=pt
Корейски=ko
Унгарски=hu
Японски=ja
Гръцки=el
Френски=fr
#Tue Apr 10 01:09:46 CEST 2012
български\ (България)=bg
български=bg
