#lng2name_VO
Latviyänapük=lv
Larabänapük=ar
Linglänapük=en
Deutänapük=de
Ido=io
Galiziänapük=gl
Friuliänapük=fur
Latin=la
Polänapük=pl
Grusiyänapük=ka
Loxitänapük=oc
Sloveniyänapük=sl
Lasturänapük=ast
Velsänapük=cy
Türkänapük=tr
Frisänapük=fy
Volapük=vo
Sperantapük=eo
Lietuvänapük=lt
Larmeniyänapük=hy
Spanyänapük=es
Katalonänapük=ca
Svedänapük=sv
Suomiyänapük=fi
Lukrayänapük=uk
Rusänapük=ru
Malteänapük=mt
Bretänapük=br
Lisladeänapük=is
Litaliyänapük=it
Limburgiänapük=li
Krimtataränapük=crh
Lalbanänapük=sq
Rumänapük=ro
Tsyeg=cs
Slovakiyänapük=sk
Nedänapük=nl
Danänapük=da
Malagaseänapük=mg
Mongolänapük=mn
Novial=nov
Lestiyänapük=et
Frikopänapük=af
Bulgaränapük=bg
Pärsänapük=prp
Portugänapük=pt
Interlingua=ia
Vietnamänapük=vi
Koreyänapük=ko
Macaränapük=hu
Yapänapük=ja
Grikänapük=el
Fransänapük=fr
#Tue Apr 10 01:09:46 CEST 2012
